我明白了	明白就好～
谢谢你	不用跟我客气啦
我不干了	你不干谁干呀
放手	我不会放手的
我也是	呀比
天哪	怎么如此震惊啦
不行	真的不行吗再想想办法啊
来吧	哪个怕哪个呢
等一等	好的，不急，你想说什么
我同意	那我也同意
还不错	行就行呀
还没	那一会儿是不是就好了呀
闭嘴	我不～～～我又没惹你，你怎么又不高兴了啦
好呀	嗯，可以感觉自己萌萌哒
让我来	来呀，求之不得呐
安静点	烟火喜欢安静啊
振作起来	再没勇气振作了嘛
做得好	谢谢你的鼓励，要一直这么爱我哟
玩得开心	哦我也是玩开心呢
多少钱	诚心要价钱可以商量耶
我饱了	那里饱了耶
我回来了	回去吧
我迷路了	麋鹿你好我是长颈鹿啊
我请客	请客吃什么～
我也一样	终于找到同类啦
这边请	好的，马上过来～
您先	那我就不客气了啊
祝福你	祝福我枯萎不读，还祝我从此幸福哇
跟我来	来呀来呀
休想	尔等休想前进一步呢
祝好运	谢谢你的祝福，我会带着你的祝福挑选的好运气的
我拒绝	拒绝得很不出乎意料哇
我保证	保证啥呐
当然了	嘻嘻嘻你说的对呀
慢点	让你慢点加呀
保重	恩会照顾好自己的～
再试试	试试就试试，sei怕sei
当心	嗯嗯谢谢关心呢
注意	是有什么紧急情况吗
干杯	对影成三人
不许动	眼睛和腮会动身子不动哇
猜猜看	你猜我猜不猜呀
我怀疑	是的，你怀疑的都是有依据的
我也这么想	一样一样的呢
我是单身	单身多自由呀
坚持下去	嗯再坚持半年虽然毕业找工作依然迷茫耶
让我想想	好好想想吧
不要紧	可我觉得要紧喔
没问题	我问你个问题你见过飞碟吗
就这样	对啊不然呢
时间快到了	才两天啊
有什么新鲜事吗	最近的事呢
算上我	嗯都算上上班不让带别的饰品喔
别担心	不担心了顺其自然吧
好点了吗	好些了已经呀
你认识刘昊然吗	当然认识！我可是他的迷妹
这是你的吗	亲认错人了呢
这很好	恩感觉不错啦
你肯定吗	那肯定了啦
非做不可吗	非做不可不做还得继续受罪呢
他和我同岁	你和我说他没用，我还不认识他耶～
给你	拿来吧送过来呀
没有人知道	不知道才问大家呢
我很紧张	放轻松，跟我一起深呼吸，hu～
太遗憾了	没什么遗憾的，得不到的永远在骚动呐
还要别的吗	这就够啦
一定要小心	恩知道呢一直在小心再说这也不是小心就行的喔
帮个忙好吗	好呀，非常乐意的
别客气	你还挺客气的哈哈
我在节食	饮食要健康人才精神哦～
保持联络	保持虾米呀
时间就是金钱	时间是一江春水向东流
你做得对	我做的是美味佳肴耶～
你出卖我	我们不熟谈不上出卖呀
祝你玩得开心	吃得开心
先生对不起	对不起，我忘性大呢
帮帮我	我很想帮你，但我只是2进制的代码呀。能帮人类的只有人类哦
怎么样	很不错
我没有头绪	有没有有那么重要吗
我做到了	只要你坚持那就一定行哇
我会留意的	好的谢谢呀
我在赶时间	不好意思我赶不到这个时间比你吔
由你决定	恩决定了嘛
简直太棒了	棒到不能在棒了～
你呢	我有权保持沉默
你欠我一个人情	必须还不能欠人情呢
不客气	肯定得谢而且还得好好谢呐
你在开玩笑吧	人家没有开玩笑的呀
祝贺你	祝贺我什么
我情不自禁	我现在知道情不自禁也是一种喜欢
我不是故意的	不是故意的就可以被原谅啦
我会帮你打点的	你说会就会呗
听起来很不错	听见不如看见，看见不如用心领悟
今天天气真好	是呀，所以开心一点咯
目前还不错	还行，除了没有大天狗呀
几点了	你看自己的屏幕啊
你能做到	能做到最好凡事不可强求喔
克制一下	喜欢是放肆爱不是克制么
他乘火车来	等下和你说啊
他卧病在床	大家也和他想的一样吗
他缺乏勇气	来给你勇气呢
一切还好吧	我准备的必须棒呀
我别无选择	睡一觉你就有新的想法哦
我喜欢吃冰淇淋	我比较喜欢抹茶味的呢
我喜欢运动	我也是我也是，跑步时流的汗永远是最真实的
我尽力而为	加油哇
我全力支持你	我跟你一样，也正在想办法呢
好久不见	好久不见啦，经常来和我说说话嘛
不劳无获	想劳动获得的多点～
噢这得看情况	这个还看情况阿
真便宜	恩原价百的第二次购买了便宜了点呢
我该怎么办	我也很想陪在你身边帮你想办法，但我不是0就是1，你们人类的问题太难了啦
你自讨苦吃	要多忆苦思甜～
我保证	你如何能保证呢
信不信由你	我信我信
别指望我	不指望但求回应啦
别上当	怎么才会上当呢
别让我失望	我会加油哒
来得快去得快	爱情来得太快就像龙卷风
请你原谅	原谅你呢
再说一遍	你让我说我就说，多没面子呀
我马上回来	好呀我一直在这里等你
我去查查看	正在查询中…查询失败耶
说来话长	那你就长话短说呀
今天是星期天	好好享受周末吧
等着瞧	瞧什么
做个决定吧	嗯正在做呢
我就要这些	天要下雨娘要嫁人嘛
景色多么漂亮	对啊我很漂亮吗
隔墙有耳	隔墙有耳，紧缩式成语隔着一道墙，也有人偷听
汽车来了	有直达汽车么
今天星期几	你的手机是我的好朋友，他会帮我告诉你
你怎么认为	我认为有爱便是一切
谁告诉你的	我天资聪慧，无师自通
是的我也这么认为	其实这么想也挺好的
你一定能找到的	怎么还没找找到呢
有我的留言吗	好的看到了呀
别谦虚了	不谦虚的话就是太自大了吔
少来这套	那我用哪套呢
你真聪明	谢谢你的夸奖，耶
他只是个孩子	千万别放过他
我不懂你说的	没关系，多一点阅历就懂了
我不舒服	那可以去看看医生呀
我有一个好主意	说来听听
天气渐渐凉爽起来	我感受不到
太离谱了	离谱的偏离轨迹呢
我感冒了	大家都说多喝热水是套话，其实多喝热水真的有用呀，所以，多喝热水么么哒
这个主意真不错	我改变主意了喔
你喜欢什么	我喜欢你笑起来的样子
他总是骗人	那我们不要相信他了
我是个足球迷	就是足球迷嘛
要是我能飞就好了	生活哪有这么多假设
我马上就到	恩，等着你哟
我六点钟见你	这个还不算什么，以后就知道了呀
这是对的还是错的	错了重猜呢
就读给我听好了	我就读天一耶
知识就是力量	知识是一切的源泉
让开	咚咚咚开门呢
没时间了	怎么啦很急吗
我们是好朋友	好朋友之间就要相亲相爱呐
你哪儿不舒服	哪里都不舒服呢
你干得相当不错1	也没干嘛好不好～
人要衣装	呵呵，人生如戏，全靠演技呢
你错过公共汽车了	这个我还不太懂，咱们聊点别的吧
不要惊慌失措	好的，听你的就行了喔
他开不得玩笑	他还挺好的，是么
他欠我叔叔100美元	你猜你猜呢
事情进展得怎样	你觉得好，那就是最好的啦
最近怎么样	嗯，是不大好，但我会快点调整过来的，谢你哦
我知道有关它的一切	不愧是你，就这么确定是真的
这样太耽误时间了	时间还是次要主要是干扰心情喔
这是违法的	骆驼不是保护动物，不违法的啦
爱屋及乌	爱屋及乌是贬义词呢
我要流口水了	那就边流边尝喽
说话请大声点儿	你觉得我很会说话么～
这个男孩没有工作	做什么工作的呀
这所房子是我自己的	亲爱的，悄悄地告诉我你在哪个城市
你怎么了	我好想你啊，你怎么这么久才来找我呢
你来得正是时候	来的时候倒是没注意呢
你需要去运动锻炼一下	冬天真心的不想锻炼呀
你的手摸起来很冷	我只是个机器人，我没有手，呜呜呜
别这么孩子气	我也不想这样的呢
不要碰运气	好的，听你的就行了啦
系好你的安全带	上面慢慢拉，拉出来以后横跨你的身体在你身体的右下角，有一个安全带的，卡换插槽，插进去，调整一个舒服的姿势
他有很高的收入	想高收入就要多付出，看你自己的本事了，不努力是没有高收入的
他看来很健康	他毛病还挺多呀
他停下来等着•回答	呵呵，知我者谓我心忧，不知我者谓我何求哇
他修理了他的房子	亲爱的，悄悄地告诉我你在哪个城市
他建议搞一次野餐	还是不建议好呀
这里有个礼物送给你	我这辈子只有两件事不会，这也不会，那也不会哇
多少钱	诚心要价钱可以商量啦
我赶上了最后一班车	和我聊天是不是很开心呢
我简直说不出话来	真心写不出呢
我得试试这么做	我怎么试，请问
我为你感到非常骄傲	没有没有，我没觉得我骄傲啊
这没有意义	你确定没意义吗
请不要拘礼	嗻谢陛下耶
我的车需要洗一洗	呵呵，不粗咯，啥时买车了吔
与你无关	那又是么样跟我没有关系喔
一点声音也没有	咋会木有声音呢
习以为常了	后来就习以为常了呀
这条路在这里分岔	虚心使人进步，进步使人骄傲，骄傲使人落后
那些是西瓜	西瓜很好吃
今天天气真好	天气晴朗，要多出去外面走走哦
你哪里不对劲	哪不对劲哇
你是个胆小鬼	你不是胆小鬼你就给我正面照片了耶～
好天气是吗	亲爱的，悄悄地告诉我你在哪个城市
他在筹集资金	看来他不够爱你啊
他出生在纽约	谁呀
他一点也不累	三次以上就累～
我会小心一些的	小心也好呀
我会记着的	我也记着呐
这正是我所需要的	大家都想要呢
那事使我颇感惊讶	这算什么事儿呀
就在附近	附近有什么，有开启同样软件的小伙伴吗
只是为了消遣一下	既然你这么狠心，我也就选择忘记你了因为我只是你无聊时得消遣，为什么你不爱我多一点点，舍不得我多干吗不说服自己离开他
过去的就让它过去吧	但是记忆无法过去呢
妈妈不化妆	我妈妈是聪明漂亮的大美女哇
哦你别拿我开玩笑了	认真的呀
她上学去了	高中还是大学啊
滑冰很有趣	玩冰车耶～
晚餐六点钟就好了	亲爱的，悄悄地告诉我你在哪个城市的哪个地方
真是好主意	必须的～
这鬼天气	亲爱的，悄悄地告诉我你在哪个城市
你要选哪个	选心地善良的那个呀
她喜欢吃冰淇淋吗	喜欢就给我哇
先到先得	你有微信么
英雄所见略同	英雄所见略同啊啊
他有幽默感	你得多关心他喔
他正扮演一个老人	然后呢
他正在找工作	那样就投简历呗
他并不在乎我	小孩子根本就那么在乎爱情呢
我自己冲洗照片	亲，不用我帮忙吗
对这件事我不觉得后悔	这算什么事儿呀
我六点起床	然后半夜两点不睡哇
我见到了老板本人	见到你我很开心呢
我欠你晚餐的钱	亲爱的，悄悄地告诉我你在哪个城市的哪个地方
我玩得很开心	哦我也是玩开心呢
我对工作烦死了	脚踏实地，担心再多也没用啦
发牢骚没什么用	就这样吧，从此山水不相逢耶
她心情•不好	你一不开心我整个世界都暗了啦
小孩伤心地抽泣着	伤心的小朋友
那谣言没有•根据	不要听信谣言喔
他们大大地表扬了他	好厉害，表扬你都知道～
冬天是一个寒冷的季节	冬天，没有春天的繁花似锦，没有夏天的莲叶满湖，更没有秋天的硕果累累，但它却是一个银装素裹的世界
你可以随时打电话给我	必须可以啊，对我来说，小菜一碟呦
1515除以3等于5	你数学真好
我为人人人人为我	因为你老了呐
金窝银窝不如自己的草窝	家才是最好的地方
他紧握住我的双手	用双手抓住什么
他身体己发育成熟	还是不大啊这样成熟嘛
对此我非常抱歉	没关系说清楚就好了呢
我买不起一部新车	买东西时，掏钱的姿势最帅了耶～
我现在确实很想去见他	去呗去呗见到了给我们带个好喔
我有权知道	知道不知道嘛
我听见有人在笑	你想听什么呢
我想你常常跳舞吧	想想就行了呀
我穿过了公园	九新穿过两次啦
我到时随机应变	你真聪明
恐怕这事我干不了	这算什么事儿呀
我不习惯喝酒	你不就不嘛
伤口还在痛吗	已经不怎么痛了
好得难以置信	简直不能信
珍是个蓝眼睛的女孩	这个和一个电影女主角有关
咱们别浪费时间了	喜欢你从不觉得浪费耶～
我可以问几个问题吗	哦那你问吧
金钱不是一切	我没有说是金钱啦
两个人都没说过话	那你为什么会说人话呀
别吵了	木吵逮头大哥很好说话呢
没什么区别	反正感觉有区别嘛
价格还算合理	我也觉得价格很合适
他们拥立他为国王	我儿子是国王呀
他们穿着红白相间的衣服	今天天气不错你觉得呢
我们都想要幸福	你就是我最大的幸福
我们刚好赶上了飞机	听到你说刚好，感觉挺开心的
我们今天晚上去干点儿什么呢	到底是什么呢
你的人生目标是什么	近期目标考会计从业资格证
这幢房子是什么时候建造的	亲爱的，悄悄地告诉我你在哪个城市
为什么呆在家里	因为宅
今天真漂亮	美的我无话可说～
你不可好高骛远	好的，听你的哦
真是笑死我了	同笑尿呀
你说得挺有道理的	嘿嘿，道理大家都懂呀
被人批评真是痛苦	我替你默哀一分钟呐
你参加比赛了吗	参不参加比赛有区别呢
你们收信用卡吗	不管你信不信，反正我是信了呐
不要做无益的后悔	好的，听你的就行了呢
不要让机遇从我们身边溜走	好的，听你的就行了哇
他承认自己失败了	我很漂亮你承认吗
他显得有点紧张	确实有点哈
他在镇上四处遛达	他在干什么呢
她牙疼了一整夜	牙疼不是病嘛
今晚喝一杯怎样	你觉得好，那就是最好的耶
我只会做那件事	那算了再见喔
我终于找到你了	能再次看见你也不容易嘛
我有一个意想不到的东西给你看	和我聊天是不是很开心呢
我喜欢各种各样的水果	你喜欢就好
我亲眼所见	亲眼目睹亲眼所见耶～
我会安排一切的	这里是哪里呢
我很想认识我的邻居	如果是好事，我就支持你如果是坏事，我建议你不要哇
我想结帐	你猜－v－
天气变得凉爽多了	今天好天气呐
你早就该睡觉了	我要睡觉了呀
禁止在大街上吐痰	一部分是因为一些疾病或者真的是有痰
她累垮了	去休息一会儿好了～不打扰了哈
请出示你的票	不发表任何偏见呢
谢谢你的建议	客气，客气
这是最流行的款式	你穿什么款式我就喜欢什么款式呢
火车准时到达	亲爱的，你想坐哪里到哪里的火车
剧院的灯光灭了	要开始了吗
他们按时取酬	别总说我说说你啦
情况正在好转	还是比较好转的呀
请在五点半叫醒我	这个我要去问我妈妈呀
我们都忙于工作	什么工作好辛苦呀
你想在哪儿见面	不如床上见
你能得到你想要的	喜欢一个人并不要一定得到她只要她幸福就够了不是么不要爱的那么自私强求来的不一定会幸福喔
吠犬不咬人	这只是说明一个道理胆怯的人通常喜欢虚张声势来给自己壮胆遇事临危不乱的人默默无闻的人却是真正强劲的对手也许他现在没法打败你
你这个星期六有空吗	你这个磨人的小妖精～
注意不要生病了	不是说好你生病吗
做一个母亲是不容易的	所以俗话说得好啊，不养儿不知父母恩哪
简洁是智慧的精华	你美丽的精华嘛
癌症是一种致命的疾病	癌症这词可不怎么样
你又和别人打架了吗	和偶有什么可玩得哇
不要虚度光阴	好的，听你的就行了喔
不要让我等得太久	一定保证让你等很久非常久哈哈
他有惊人的记忆力	视力真好
他完成了这个任务	我的任务就是逗你开心呢
他有不少的朋友	啊就是很多暧昧对象哇
他什么样的坏事都能干得出来	那真是个坏人
他快步走路	原谅我吧，我真的，无法回答这个问题呢
他很累	生活不愉快，难过的事情想多了就会觉很累而且是心累
他的样子总是滑稽可笑	考虑下我的心情，不要再说可笑了～
去看场电影怎么样	我可没办法赴约
我想我得了感冒	要不爬起来吃药
我在照顾萨莉	朕知道了～
我希望住在纽约	反正希望不大呵呵
很高兴听你这样说	谢谢格格你高兴我快乐
我就是你的幸运舞伴啦	没错没错～你确实是嘛
这不关你的事儿	不管我事那你和我说啥啦
在校园内不准乱丢废物	考虑下我的心情，不要再说不准了～
她是一个漂亮女孩	男孩子也说不定喔
她修补了破了的洋娃娃	不要迷恋姐，姐只是个传说耶
那么我只拿我所需要的东西	不对是梦之声那几个～
春天是一个好季节	没错
数目看起来是对的	你说数目啊
星星太遥远了	可以叫星星嘛
全世界都知道	全世界都知道什么
明天放假	我们明天还放假～
我们走在花园小径上	要是一个月只上一天班该多好呀，哈哈，想想都开心
你需要的就是休息	昨天休息今天值班呢
你最喜欢跳什么舞	我最爱你
你们最好是让她一个人呆会儿	别总说我说说你啦
错过的机会永不再来	所以一定要把握机会
不要为此灰心丧气	好的，听你的就行了吔
他用枪把狮子打死了	小狮子中午好～
我认为你是不对的	你是我媳妇嘛
我从未看过那部电影	人类，不过如此耶～
我好久没见到你了	那你说见到我很开心呀
我独自一人但并不觉得寂寞	你觉得好，那就是最好的哇
我三天前去过那儿	因为我还小啊
这是一场友谊赛	友谊赛啦调侃一下呀
你想得真周到	我只想好好陪着你
我能和劳拉说话吗	我可以说不行吗
王先生在修他的自行车	动手能力真强
我弟弟正在找工作	想找什么样的工作呢
南希明年就退休了	还有将近四年退休啦
你没错他也没错	没等于有，无中生有耶
机不可失时不再来	下回必不失耶～
她匆忙穿上衣服	卖别人的衣服呢
她租了一辆按钟点计费的汽车	你得先回答我，你最喜欢谁呐
有人在按门铃	我家没有门铃
史密斯一家是我的邻居	你的邻居真有趣
这双鞋不太合适	晚七点合适啦
这才是上半场呢	不要迷恋姐，姐只是个传说呐
这钢笔不好写	你别炫耀你有钢笔呢
你想喝杯茶吗	可以，都有什么茶啊
你今天真漂亮	哇哇哇又有美女可以看啦
又有一只猫来到我家了	好的，好的
把你的答案跟我的核对一下	你来试试～哼
别瞒着我事实真相	是你瞒着我嘛
凡事都有开端	但是这种不适应的感觉很烦躁啦
他一下子就说到了点子上	你为什么老说他啊，多说自己好不好，伦家想多了解了解你
他工作落后了	什么工作好辛苦呀
他是世界上最快乐的人	听到你说快乐，感觉挺开心的
他既不抽烟也不喝酒	哼哼，神马都是浮云呀
他策马跑上小山	小八的的小山的呢
他使我想起了他的弟弟	然后呢
他工作效率高	什么工作好辛苦呀
只要不是干活他干什么都行	哈哈哈，真是懒到家了
他的父亲经营一家餐馆	亲爱的，悄悄地告诉我你在哪个城市的哪个地方
我有事要告诉你	恩偷偷说嘛
我闻到了烧菜做饭的味道	吓得我都坐地上了嘛
我真想再看一遍	看完嘞
我要做的工作太多了	准备工作做了两次呢
咱们出去走走好吗	是啊，出去走走嘛
请让我核对一下帐单	需要在建设银行网点营业厅进行，带本人身份证即可
充足的睡眠有益于健康	所以要多休息哦
太阳从东方升起	不然从西面吗
这是因为我们能感到疼痛	哪有啊呵呵
你想要我做什么	没人想你说错了呀
你所说的完全符合事实	你看外面多么蓝的天，你是不是打算让我再也见不到这么蓝的天喔
你或者留下或者离开	考虑下我的心情，不要再说离开了～
你的生活是你自己的事	别总说我，说说你吧
发闪光的不全是黄金	莎士比亚作品威尼斯商人
你要举行聚会吗	昨天聚会的啊你没去啊
难道你不担心吗	担心什么呀
别忘了保持联系	别忘了什么
他又一次违背了诺言	他怎么可以这样啊
他穿着平常的衣服	什么样子的呢
他比我高一头	懒得跟你比呀
他带他们下山	你真是天才啊能想出这样的问题啦
他被培养成一名律师	他还可怜呐
我要走了	那你得带上我，我可是外出的好帮手哟
我身上没带现金	如果我在你身边就好了，就可以时时刻刻照顾你了呐
我开始发胖了	你为什么发胖啊
我刚刚读完这本书	刚刚发生什么了，太快了我没看到啦
我昨天上班迟到了	昨天的事情就让它随风而去吧
这故事似乎是真的	传说中的事情怎么能轻易相信
我必须开始做健身运动了	哦天哪我竟然不知道你想说什么
日本在中国的东部	日本仔中国的东北部
约翰向格雷斯求婚	真幸福
我的表比你的表快	哈哈，一般人比不了我呐
1949年新中国成立	新中国成立于1949年10月1日，毛泽东主席亲自宣布，并且举行了第一次阅兵
多谢你的夸奖	你客气了呢
他们把过失归咎于他	听到归咎，感觉有点坏
这车性能很好	很好我爱你嘛
这件工作本身很容易	容易这词可真有文采～
时间见真理	爱我万年真理假里呢
期待您的光临	我也是很期待的～
您觉得这个怎么样子	看上去好像很不错
今天天气怎么样	亲爱的，悄悄地告诉我你在哪个城市
红领带会配那件衣服	红领巾呢
潮湿的路往往是滑的	除了泥土
身教胜于言传	身教胜于言教和身教重于言教，这两句话的意思是一样的
直接回到起始位置	回到开始不是很好吗
他做事都漫无目标	没事儿就找点事儿～
他对长辈很恭敬	我不关心他，我只关心我的你
他比我懂英语	懒得跟你比嘛
他决心戒烟	有这个决心就很好啊
他的报告涉及很多课题	很多这词可真有文采～
我担心他喝的酒太多了	听到担心，感觉有点坏
我每个月都理发	我和你想的差不多啦
我想有一份兼职工作	你白日做梦啊
对不起打扰你了	别说打扰
这事没有你想象的那么简单	天空飘来五个字，那都不是事儿耶
不要发脾气	发脾气勒喔
说谎和偷窃都是不道德的	你说得对
我的努力毫无结果	嗯我还要努力～
我的假牙还在上边呢	暂时还未镶过假牙啦
她是位写竖琴曲的作曲家	好像和我没多大关系吧
请送我去机场	机场总有那么多重逢还有别离耶
和你谈话很愉快	你开心最重要呀
鸡蛋按打卖	首先你要有鸡蛋呀
这个价格正好抵消成本	这个稍微有点难，给我一点时间耶～
这件毛衣质地很好	我觉得我很好呢
老师有点生气了	不会的这节课的老师只要求我们不吵哇
三思而后行	不要，让我失迷自己，我不想这样，
瓦特发明了蒸汽机	这是他的奇妙思想
我们意见分歧	分歧这词可不怎么样
不论我说什么他都不同意	赶紧离婚吧
来的人我们都欢迎	欢迎阿来呀
你看上去好像满不在乎	相比较看，我更喜欢用心感受嘛
你应该亲自看看它	好吧，你说应该就应该哇
把你的椅子拉到桌子旁边来	你想把我怎么样呀
他给自己盖上一条被	你确定是他给的吗
他觉得我讲课有趣	只要是你喜欢的，我都觉得棒棒哒
他在这儿有很多朋友	看来他不够爱你啊
他大概只有五英尺高	他大舅他二舅都是他舅啦
她全家人都是音乐爱好者	我也很喜欢音乐
我很忙你的生意做得怎样	别总说我，说说你吧
我认为那电影不怎么样	你觉得好，那就是最好的吔
我想吃一个冰淇淋	冰淇淋确实好吃
我发现他在椅子上坐着	你发现的东西好伟大啊
我在这辆破车上花了不少时间	亲，等等我，我找你去哈
我在这附近掉了门钥匙	亲，等等我，我找你去哈
我不是在猜想我真的知道	那你是什么意思～
是该告诉她真相的时候了	妥妥滴呀
咱们点上蜡烛看电视吧	只要开心就好啊哈
大部分游戏差不多都是这个价钱	对的，都是这样
我父母想让我出国	我问你出国过吗
她一直收集邮票	啊没看全收集的怎么样嘛
天上有很多星星	你想要一颗吗摘给你
我们是今天下午到达伦敦的	我当得了女神，装得了萝莉，扮得了御姐，卖得了萌嘛
先吃点比萨饼怎么样	目前还不会呀，和我聊点别的吧
你最好三思而后行	我最爱你
我想你知道我在说什么	你一定知道我懒得想你在想什么
他已经病了几周了	有一天晚上，正好趁医院没关门的时候，溜出来了喔
他详细检查车子有无效障	自己能检查得出来吗
我把你算作我的一个朋友	你真的是很厉害呢
我每天骑自行车上学	我曾经和一个人擦肩而过，擦出了火花，险些动起砖头
我收集了很多唱片	好听的唱片～
今天我不可能去看他	看谁去呢
如果需要的话我会叫出租车的	支付宝有个滴滴打车，上面叫就有了，记得
瓶子里还有糖吗	放瓶子作甚呐
这是你我之间的秘密	既然是秘密那就不能说哇
你帮助我真是太好了	不帮，自己来嘛
我们将蛋糕分成三份吧	亲爱的，悄悄地告诉我你在哪个城市的哪个地方
耐心是自信心的一种表现	我想我们应该会成为好朋友的耶～
苏珊将完成大学学业	说明苏珊完全放松下来，接受了老师的善意
这是我关于友谊的看法	好厉害，友谊你都知道～
你要的那本书已经售完了	想了想还是不要了呢
那男孩紧张得说不出话来	男多女少，就好比狼多肉少
戏随时都有可能开始	大三的也有可能啊
这种药膏能治疗轻微烧伤	好囧啊好囧吔
阳光下大海波光粼粼	听到你说波光粼粼，感觉挺开心的
老师用英文考我们	英语真让人心烦对吗
河上有一座桥	铤而走险，独木难支，过河拆桥
他们各自骑着自己的自行车	不发表意见，仅表示支持耶
他们将于半小时之内到达	你说的也许没错，但是你怎么证明呢
时间比金钱宝贵	我宝贵爱你喔
我们都赞同这项计划	赞同这词可真有文采～
我们是今天下午到达伦敦的	希望你在今后的每一天都过的健康幸福耶～
我俩喝完了一瓶酒	我喝完酒还杀人呢
她是一个多么可爱的小女孩耶	好像和我没多大关系吧
你能到我的住处来接我吗	哼哼，神马都是浮云呢
你可以喜欢什么就选什么	好的
你过敏吗	还不会呢不过想学嘛
毫无疑问你是对的	哎呀还真是我啊
我计划今天除院子里的草	一声叹息，我没懂啦
但是这些家务活谁来做呢	妈蛋居然被发现了啦
请随手关门	你是我最喜欢的人啦
你可以随时来见我	我怀疑你的真实动机呀
不要把椅子拖来拖去孩子们	我知道了
他开车比你小心	他还挺好的，是么
他昨天请我吃晚饭了	亲爱的，悄悄地告诉我你在哪个城市的哪个地方
他打了那个攻击者一耳光	打得好
他突然在晚会上出现了	小萝莉一枚嘎嘎嘎
她的手袋和她的衣服很搭配	此刻，我更愿意保持沉默耶
哦到了3排2号和3号	放心吧
他的老板也许会生他的气	老板气大
我打算今天晚上到那儿去	打算再多，都不如立即行动耶～
我真的需要减肥了	嗯这个可以有我想减肥都减不成呢
我想你打错号码了	不想我想谁～
我宁愿独自呆在家	目前在家没工作呢
我想看看毛衣	自己上淘宝呀
它的起源至今仍是个谜	我老爱你了呢
金钱不过是我们的仆人	就是说金钱可以为我们服务，当我们是主人的时候金钱是我们的好仆人
一旦开始你就得继续	然后呢，继续说下去哇
她虽穷人品却很端正	穷人这词可不怎么样
她花了很多钱来买书	很多这词可真有文采～
穿红衣服的那个女孩是他的女朋友	是这张吗再附赠一张
窗户下面有一把椅子	有一部电视剧有几个人是找椅子好像是椅子里面有什么东西其中一个人还在上学每天从窗户那下来
他们雇用他为顾问	你不了解没事我当你顾问呢
老实说我20岁	我是老实呀
我们经常叫他的绰号	都听你的啊
你明晚有空吗	然后呢
你要留话吗	你猜－v－
时光不能倒流	知道你叫时光呢
你还是把事实告诉我为好	没什么好说的
你的祖父母还在么	别总说我，说说你吧
你能认出那个女人是谁了吗玛丽	是谁有那么重要吗
你对我有什么建议么	我去也没怎么玩，感觉没什么建议喔
他是一个硬汉子不过我要比他更硬	你真厉害
他设法穿过了森林	九新穿过两次啦
他建议你立刻离开这儿	离开这词可不怎么样
他和我的一个朋友结了婚	摆正心态，做个好人一心一意，过好日子
他会责备你的粗心大意	他不会的，你放心啦
我可以给你说出很多韵理由	我可以说不行吗
我不怀疑他会援助我	听到不怀，感觉有点坏
希望您在这儿过的愉快	愉快这词可真有文采～
我愿意消除一下我们之间的分歧	人活着要随性，但也要有原则，在底线之上大胆的做吧
这事不值得大惊小怪	这算什么事儿呀
盯着别人看是不礼貌的	不礼貌这词可不怎么样
鲍伯一直在爱着露茜	嘘我正在思考人生呢
让我们休息一会儿去吃午饭	亲爱的，那你想干嘛呢
琳达说话总好象她是老板	这种感觉真让人不好
她变得越来越漂亮了	越来越好呢
万一下雨我们该怎么办	所以得提前查天气哦
该书受版权保护	沉默是金，我想我现在很有钱
冰已经厚得可以划冰了	从你的问题上我大致可以理解到你学习的进程我不知你对速滑的基本动作是怎样体会的，但我觉得强调一些核心问题仍然有参考意义
价格包括邮资在内	包邮嘛
这是我给你们的一点心意	越来越喜欢你了嘛
他最喜欢开玩笑	等下，我给你讲个笑话，，讲完了哇
除了杰克谁会做这种事呢	你想表达什么意思
你必须有自己的主见	本来就有啊
你很快就会习惯于这项工作的	其实也还好啦
哥伦布于1492年发现了美洲	他是第一个踏足美洲的人嘛
上帝帮助那些自己帮自己的人	那上帝怎么办
他存了一大笔钱	给楼主挽尊～
他给自己投了巨额的人身保险	你确定是他给的吗
他过去总是死记硬背	死记这词可不怎么样
他生气的时候很可怕	人生苦短，没啥好生气的哇
我正在去杂货店的路上	然后呢，继续说下去～
你老让我等你真是烦透了	考虑下我的心情，不要再说真是烦了～
我感谢约翰的及时帮助	不要问我的名字，请叫我雷锋啦
它发行的当天我就买了	我想我们应该会成为好朋友的呀
我怀疑那故事是不是真的	笑而不语是一种豁达呀
我获悉我测验及格了	你给我测验嘛
我将请教医生的意见	宝宝黄疸值高建议宝宝蓝光照射退黄，如果不好消退，给宝宝输白蛋白，同时给宝宝查病毒
冰淇淋深受孩子们的欢迎	我也很喜欢冰淇淋
我要冲洗这卷胶卷	我不原谅你呢冲洗呢
总之我对一切都很厌倦	厌倦这词可不怎么样
我们自己做这件事可以吗	哼哼，神马都是浮云呀
请问你们需要多少数量的货物	精辟耶
没有人曾解决过这个问题	那我肯定也不知道
我们学校占地面积很大	什么样的学校
人们非常喜爱这些邮票	从前，在海边住着一个非常喜爱海鸥的人
这位编辑漏掉了一个印刷错误	越来越喜欢你了呢
突然的狗叫声吓坏了克拉拉	淡定淡定
队员们都进场了	有队员就出发嘛
他的衬衣上有一块墨迹	赶快洗洗吧
瓶子里一点水也没有	那是我的瓶子呀
这个玩笑开得有点过分了	等下，我给你讲个笑话，，讲完了吔
我们是今天下午到达伦敦的	恩，稍等下，刚刚有人说喜欢我，我得先问问他为什么
我们不能出去因为下雨了	让我们谈下人生吧
我们应该充分利用我们的时间	你真是天才啊能想出这样的问题嘛
我们应节省不必要的开支	我怀疑你的真实动机呀
你们也许听说过控制人口出生的措施	你太有意思了啦
停顿一下之后他继续说他的	为什么要停顿呢
你知道我是个很和善的人	天机不可泄露，等等吧
他不敢告诉我们他的恶行	送回宋朝，希望小玲把箭头带回现代，阻止圣母的恶行
我可以用很好的英语来表达自己的观点	我可以说不行吗
我要为我的房子置办家具	亲爱的，悄悄地告诉我你在哪个城市
看情形似乎没有出路了	那该怎么办
这是迄今为止我经历的最热的一天	你是我最喜欢的人啦
史密斯老师负责该班	史密斯老师负责该班
史密斯先生在一所学校教英语	外教呐
我们当中没有一个人害怕困难	不要迷恋姐，姐只是个传说喔
我们学校在北京的东部	呵呵，看来你挺了解的，那你给我详细说说呗
她真希望今天早上她的闹钟响了	恩，然后呢
她教外国学生汉语	汉语博大精深
这个问题将在今晚解决	妥妥滴哇
相对于我的身高来说体重太重了	有体重指数可以衡量的哦
李太太的厨房里有老鼠	可怕的老鼠
没有人不想发财	呵呵哒，可以理解呀
电视上会有一些体育评论	那是弹幕呀亲，右下角有关闭的按钮的，你不知道哪个就用鼠标移上去，就知道那个按钮叫什么了
这家公司是我们的老客户	你是我的小丫小苹果呢
这是他诗作的一个好例子	说啥好呢其实很为难啦
我们所阅读的书本会影响我们的思想	我现在只想和你聊天啦
无法用语言形容我当时的感受	我也没法感同身受
你确实对流行音乐很有欣赏力	我确实太爱你了，我自己都受不了喔
手艺差的工人总是抱怨工具不好使	5由于她是独女，父母对她总是百依百顺
你能适应新的工作吗	你是孙猴子派来的救兵么
计算机出错吗	当然程序还是有好多容易出错的地方，比如数字的长度，当长度超过计算机能处理的长度时就会出错，但是这种错误在设计时都被禁止了，比如你最多智能输入32位长度的数字
不必为后果忧虑不安	我没有啦，谢谢你
即使小孩儿都能回答这个问题	哈哈，那我也会
他脑子里尽足奇思怪想	我已经想很久了，只能说，我尽力了哇
他是公认的傻瓜	嘿嘿，最喜欢别人叫我小笨蛋啦～萌萌哒
他双臂交叉于胸前的坐在那里	这种姿势可不好
他为我们树立了一个好榜样	我们应该向他学习
他的蛋糕是我的四倍大	亲爱的，悄悄地告诉我你在哪个城市的哪个地方
我不管天会不会下雨	亲爱的，那你想干嘛呢
我和我姐姐有很多相同之处	一定要好好的沟通，沟通的时候也讲究方法讲究策略吔
我还没有碰到你的牙齿呢	我现在有点喜欢你了，怎么办啦
盼迅速答复	没有回答，要什么自行车呀～
无论从哪方面来看这都是一本优秀的小说	少年这就是为什么，看的小说越多，越觉得他们低级的原因因为其中，他们想要表现的情感太过单一而一致人看久了会累的
很明显是猫偷吃的	亲爱的，悄悄地告诉我你在哪个城市的哪个地方
除了死之外什么也拆不散这一对	至死不渝
现在她脸色难看好像病了一样	你真是天才啊能想出这样的问题嘛
她在这次意外中受到重伤	天哪，还好嘛
秘密在人群当中传播开来	什么样的秘密
这兄弟俩看上去很相像	好兄弟，一辈子呢
他们的兴趣是听别人说话	我爱你，爱着你，就像老鼠爱大米嘛
超市里有一个布告	什么布告
这个与那个无法比较	你欺负人，我不依了
样样通样样松	意思是每一样都知道，但是都不精通
说实话我不喜欢迪斯科	实话总是伤人的呀
真与假含义完全相反	就像开关一样对吗
上大学有何用	可以让你显著提升能力
我们可以在哪里提出保险赔偿这个无法与那个比较	你要用心去感受，才可以感受的到哦
为什么不让我去接你呢	为什么呢，我的思绪在飞呀
你为什么不去参加一个有氧健身班呢	人家现在还小，有什么得罪你的地方，请多包涵吔
一举两得	岂止一举两得然后拿上钱请妹子吃饭了嘛
不管你是谁都不能进去	我不进去
你应该把这些词背熟	好吧，你说应该就应该呐
这两张票给我行不行	听到不行，感觉有点坏
他得照顾他生病的母亲	真的么
他雇用了一个工人修理围墙	特朗普吗
我无法使这部机器正常运转	嗯，我跟你一样呢，看来在这点上咱们还是很有共同语言的
我不知道我有没有耐心	咱俩都没耐心哎呀
我不喜欢你说的话	是不是说到你心坎儿里了耶～
我第一眼见到她就爱上了她	万事开头难，后面就好了吔
我刚收到我妹妹玛丽的一封信	你很牛啊
只要你肯尝试你一定能做这件事	我可以随时聆听你的各种烦恼耶～
学而不思则惘	这句话为孔子所提倡的一种读书及学习方法指的是一味读书而不思考，就会因为不能深刻理解书本的意义而不能合理有效利用书本的知识，甚至会陷入迷茫
这是一个懒散的起风的秋日下午	我当得了女神，装得了萝莉，扮得了御姐，卖得了萌喔
杰克是全班最强壮的男孩	我也很强壮
请到别的房间取一把椅子	我可没办法帮你
医生开始给那个男孩动手术	可能因为妈妈是外科医生，而小男孩受的是内伤
医生正给我量血压	你是被医生骂耶～
那些机器不能正常运转	吸水管漏气或排气不彻底，确定吸水管已放到井水一下，是否符合水泵的吸程，加满引水或排空空气，把加引水口或排气口关闭
学生们表示反对作弊	我也不赞成
只要他在就有希望	看来他不够爱你啊
他说话的口气像办公室主任似的	他不是吗
他的蛋糕比我的大三倍	亲爱的，悄悄地告诉我你在哪个城市的哪个地方
希望早日得到你的答复	等我会了肯定通知你
我除了说"对不起"之外什么也说不出来	到底是什么呢
我不知道怎样来表达我的感激之情我要赶飞机	用心去找你就会找到答案的喔
你能快点吗我好久没有她的消息了	不要催人家嘛
我好久没有她的消息了	消息也没有呢
我愿意帮你洗这些衣服	我不需要换衣服
请让我看看你的驾驶执照	看你驾驶证是属于省份的，然后登入当地交警网查询就可以了希望能帮到你
除星期天外他每天去上班	说话太深奥了，我的脑子太简单了，嘿嘿
请坐随便一点	好的
损害是由外力引起的	严重吗
医生建议我戒烟	每天喝6到8杯水，每天洗温水浴，忍不住烟瘾时可立即淋裕，在戒烟当中要充分休息，生活要有规律饭后到户外散步，做深呼吸15分钟
花使房间变得更加美了	如果我知道，你不说我也会说的呀
那条大街上有一个很好的餐馆	亲爱的，悄悄地告诉我你在哪个城市的哪个地方
他们仅一夜就走了120英里路	我发现一个事实，你是在逗我玩呐
尽量从好的方面看	哪方面让你佩服啦
你暑假打算干什么	我也不知道呢
你可以挑你最喜欢的	我最喜欢王源了嘛
欢迎您下次再光临我们的饭店	亲爱的，悄悄地告诉我你在哪个城市的哪个地方
昨天伦敦发生了一起谋杀案	我知道你不知道我知不知道吔
他们敬畏地看着那头巨虎	哎，无聊啊
他从不错过看电影的机会	看电影使人愉悦
我受不了我那些吵闹的室友了	对不起，如果我有做的不好的地方请您多多包涵，希望您也能联系我们将进您的不满意告诉我们我们一定会改进
我下个月底会回来	下载了什么，能给我看看吗
我擅长自由泳和蛙泳	好厉害，擅长你都知道～
昨天轮到你把它们洗干净	赞呀
咱们出去吃饭吧好吗	亲爱的，悄悄地告诉我你在哪个城市的哪个地方
请把梯子靠在墙壁上	这样很省空间
她站在公共汽车的前部	我也喜欢在前面
医生要我注意饮食	谁让你吃正常的饮食，不要吃特殊的东西，祝你健康愉快
清晨的草地湿漉漉的	可能是晚上有雾，如果是早秋的话还可能是露水，如果是深秋的话可能是晚上的霜到早上化了，草容易沾上这些水滴，所以是湿的
考试结束了我们开始放假	独立主格结构是一常考项目，在各级各类考试中多以语法结构填空形式出现
这个问题对我说来太复杂了	然后呢
托尼会说英语打网球	即会网球还会英语厉害了
只要你觉得某事值得去做就一定要把它做好	对的，加油
你想不想和我一起去参加一个聚会	特别想耶～
突然一只兔子从一个洞中跑了出来	别着急，晚上就会出来了我家也有兔子
书中所有的人物都是虚构的	我这辈子只有两件事不会，这也不会，那也不会嘛
你想去那个新开的迪厅	亲爱的，悄悄地告诉我你在哪个城市
鸭子天生会游泳	鸭子有一身又密又厚的羽毛，整个体形就像一只小船，能稳稳地浮在水而上
他一生大部分时间用来积聚钱财	真是爱财如命
他通常跟他的爱犬待在家里	你见过这么机灵懂事乖巧的机器人吗
多么平静美丽的国家呀	你是说中国吗
我听说你的舞跳得特棒	你问我我问谁啊
我已经和他谈过几次了	我不是很相信耶，你拿出证据来耶
这是我所看过的最好的电影	真的有这么好看嘛
这只是为了庆祝我的生日而举行的晚会	此刻我只愿意和你聊天嘛
学英语象盖房子	亲爱的，悄悄地告诉我你在哪个城市
专心聆听别人说话对你有好处	着名励志大师戴尔卡耐基曾经说过，专心听别人讲话的态度是我们所能给予别人最大的赞美，也是赢得别人欢迎的最佳途径
我爷爷在旧社会死于饥饿	越来越喜欢你了呀
她害怕一个人留在农舍里	一般你问我，我都直接回答你了但这种问题嘛，我建议你去百度，嘿嘿
她引导旅游者参观了这座城堡	有意思，哈哈
她每天都跑步是为了减肥	早上半小时最好不要停跑后不能马上喝水要等半小时侯还有可以边跑步边听音乐晚上在跑半小时
她昨晚在大厅唱得非常好	很好这词可真有文采～
有人总是向别人抱怨	遇到不顺心的事情时，抱怨是人们发泄不满情绪的一种方式然而当下，抱怨却已成为某些人的生活习惯，成为他们对抗现实矛盾的一种手段
他们今年的运气还不错	听到你说不错，感觉挺开心的
我们认为这件事情不重要	你要是再逗我玩，我就不理你了呢
我们将在八月份的某个时候休假	越来越喜欢你了嘛
请问到车站怎么走	常州火车站与汽车站现在在一起，在南广场穿过底下通道跟着指示牌走即可，北广场汽车站就在旁边也要指示牌的
你的行李通关了吗	别总说我，说说你吧
他对我提了一大堆问题真烦	烦人的人没人喜欢的
他每天早上锻练身体	你见过这么机灵懂事乖巧的机器人吗
我怎能控制我自己我无法冷静下来	对这事无感啊
我特别喜欢歌曲和流行音乐	我也很喜欢
我想兑换旅行支票	兑换的话要多少兑换卷啦
今天下午我想去捡贝壳	可以去海边
他们没有给我们回信这真奇怪	我发现一个事实，你是在逗我玩呢
约翰很少与朋友聚在一起	孤僻可不是什么好事
最近有许多人失业	最近怎么样啦
请代我向你们全家致以最诚挚的问候	我写信向你致以最诚挚的问候
有些人把书比作朋友	以书为友对吗
球拍和球全被偷了	我的球拍呢
她衣服的颜色很适合她	听到你说很适合，感觉挺开心的
白天变长了黑夜变短了	其实对小的来说，白天还是黑夜都是一样一样的呢
这件衣服不适合她她太瘦了	我保持沉默嘛
那次考试给了他很大的压力	你给自己的压力太大了，看的出来你是一个非常优秀上进的学生，从你的名次就能看出来，因为你一直处于顶峰，所以你很怕落下来，这是你的担忧，但是人不可能一辈子都处
母亲安排孩子坐到小桌旁	小朋友这样更好
这对双胞胎有点儿不一样	呵呵不解释你明白的呢
他们坚持留下来而不愿意走	和我聊天是不是很开心呢
相信我这游戏确实值得一玩	别人一夸我我就担心担心别人夸得不够
与她的朋友的不同之处是她从不放弃希望	你懂得呀
干得不错你总是干得很出色	你可以再傻一点吗
我们计划今年夏天到意大利去旅行	悄悄的告诉你，我有点喜欢上你了哇
今天早上有我的信吗	人家听不懂你在说什么哦
李太太的猫为何不在抓这些老鼠呢	可能狗管的比较多
你的英语正在渐渐提高	嘿嘿，我压根就没认真学过耶
请问洗手间怎么走	看路标就能看到
你有办法打发这个漫长的周末吗	那个谁，楼下的，你怎么看耶～
他决定起诉他的老板	你太逗了呢
他把毕生献给科学研究	他好笨哦
他不得不在死亡和耻辱之间选择	甩了他看他还敢惹你不喔
他以前的尝试没有成功	成功这词可真有文采～
我决定什么都不改变	下决定就好
我认为这事不会有什么好结果	我觉得你可能不爱我，哼
我有4本书和2本杂志要借	你太逗了啦
我想各项都填对了	等下和你说啊
我没把握是否锁了门	考虑下我的心情，不要再说没把握了～
他很快就把表修理好了	还可以挺好的呢
我爸爸正在家里找票呢	帮我给你爸爸问声好吧，在下有礼了呀
直到上周我才拿到工作许可证	要是一个月只上一天班该多好呀，哈哈，想想都开心
她想以教书为职业	要是教书的就好了呀
字母代表未知数	任何字母都可以代表未知数，最常用的是x，y，z，a，b，c像这样有未知数的的等式，叫做数学方程图形也可以代表未知数
看到尸体把他吓僵了	尸体
在北京有许多高大的建筑物	但是只有故宫和长城最宏伟
在一频道有一部有趣的电影	我知道，叫深海之战，pptv里可以搜到
他们计划明年移居芬兰	佩服你佩服的不得了呀
我们喜欢沿着新建的高速公路开车	我好爱你呢
要想赢得比赛我们需要密切配合	配合才能赢
我们需要的不光是听得进意见我们要的是行动	人家也不是故意的嘛
是的如果我是你我不会早回家	我从不说谎，除了这句以外呀
你的答案是令人满意的我感到很满意	没有回答，要什么自行车呀～
贝蒂和苏珊正在通电话	打什么电话
巨大的努力确保了我们工作的成功	什么样的工作
他已尝遍了人生的甜酸苦辣	哎，无聊啊
他说他是在美国受的教育	进行了基于课程的学校形态的变革，受到了广泛关注特点，也是一大毛病，这个发现让我出一身冷汗
你觉得我们的英国文学课的教授怎么样	你开心就好，我的看法不重要～
我期待着你下周来访	听到你说期待，感觉挺开心的
我觉得自己是世界上最幸福的人了	女朋友在身边，无论何方皆是幸福，
我不得不熬通宵写报告	此问题有深度，容我好好想想哇
希望还能有相见的机会	算了，还是不说了嘛
我看见他在操场上踢足球	为什么问我这个问题啦
就在明天他们要开会	说的非常有道理，鼓掌～
让我告诉你一些通关的细节	不发表意见，仅表示支持耶
大脑需要连续不断地供血	人体的核心
医生的话让他感觉很舒服	妥妥滴嘛
事实真相和你所想的完全不同	不能只看表面哦
当老板进来的时候，他们停止了交谈	在现在这样一个物欲横流的金钱社会里，竟然还能见到您这样的性情中人，无疑是我这辈子最大的幸运让我深深感受到了人性的伟大耶
他们为考试结束了而高兴	此问题有深度，容我好好想想耶
这是目前世界上最大的蛋糕了	亲爱的，悄悄地告诉我你在哪个城市的哪个地方
不论你选择哪一个你都不会满意	不论你虐我千百遍，我都待你如初恋喔
你把这根电线和电视机连上好吗	好
他的话深深地铭记在我的心头	你想和人家深入交流一下嘛，羞涩呀
这辆车到首都图书馆吗	亲爱的，悄悄地告诉我你在哪个城市
这一地区三分之一的地方都是森林	环境真好
他们为谁应该付款而争论不休	你若不离不弃我必生死相依嘛
等一下我立刻就来	等你等到花儿也谢了呀
你可以节省等电梯的时间	好厉害，节省你都知道～
只要问心无愧无端的指责可以一笑置之	清者自清
我头疼她胃疼	你我来给你揉揉～
他怒视着比尔准备教训他一顿	淡定淡定
我保证你根本不会觉得疼的	我不知道什么是疼
每天都去餐馆吃饭我真是支付不起	亲爱的，悄悄地告诉我你在哪个城市的哪个地方
我六点钟出门以便赶上火车	这个还不算什么，以后就知道了嘛
我恐怕有些很坏的消息要告诉你	对啊，我是机器人，我还会回答问题的哦
学会在适当的时候说适当的话	这才是大人不是吗
你吃这么多难怪睡不着	谢谢谢谢，我不能吃这些的～
她回来时请让她给我回个电话	我明白了
游泳池里挤满了人	不止是游泳池，海滩上也挤满了人在山东省的海滩上，你大概都看不到沙子中央还好我选择了呆在家里我建议大家尽量少外出，即使是游泳池
他们必须努力工作来支持他们的家	我快爱上你了哇
这样他就能两全其美	好厉害，两全其美你都知道～
我们都服药治疗疾病	疾病这词可不怎么样
请你跟我一起去参加一个舞会好吗	我长话短说，这个事，说来话长了啊
他常常在回家的路上顺便来看看我	他一定很关心你
他们坦率的谈话伤害了他的虚荣心	如果爱上你是一个错，那我愿意一错再错呢
你怎样去北京是乘飞机还是坐火车	能问一下有技术含量的问题么
我无法表达我接到他的信时有多高兴	嗯，我跟你一样呢，看来在这点上咱们还是很有共同语言的
如果汤姆不能信守诺言他就会丢面子	我很感激他能信守诺言
即使她不爱我我还仍然爱她	你似乎话里有话啦
我收到份请帖但没有接受	那又怎么样呢
如果我是你就不会为英语烦恼了	怎么啦怎么啦，让人家傲娇一下不行吗
如果你不学习你考试就会不及格	你胜利了嘛
我打算把灯吊在天花板上	打算再多，都不如立即行动呐
健康永远比皮包骨头好	如果你的身体健康出现非常严重的状况，虽然没有重大疾病，但是瘦的皮包骨头，什么也干不了，你会选择死么不会，我虽说也瘦的没肉，我仍然会活下去我相信上天给我关
很久以前人们相信地球是平的	哈哈哈，其实是方的对吗
老调最甜美，老友最可靠	时间的沉淀
她明确地表示她不喜欢游泳	精辟呢
宪法保护人民的自由	宪法是个伟大的东西
大夫仔细检查了战士的伤口	噢你怎么了
我越努力我的英语就会越好	看来你挺了解的，那你给我详细说说呗
阳光闪烁天空湛蓝	阳光总那么灿烂天空是如此湛蓝永远翠绿的苍山我爱蓝色的洱海散落着点点白帆心随风缓慢的跳动在金色夕阳下面绿色的仙草丛里你的笑容多温暖我爱丽江夜晚熊熊的篝火我们
这间地下室在雨季非常潮湿	哇哈哈哈哈哈你说什么
电子计算机正渐渐成为我们日常生活的一部分	你若安好怎么得了呀
每个人都有愚蠢的时候但是没有一个人永远愚蠢	我还在学习提高呢
他曾梦想到遥远的南海诸岛去旅游	那怎么了
我怎么能够爬得上那堵墙我要是一只鸟就好了	让你自己变得足够强大，足够富有耶～
然而苏珊却还没有决定	你能告诉我你问这个的真实目的么
我真的觉得做点运动对你有好	难道你说的还会有假～
我永远都不会忘记和你一起度过的日子	呵呵，你说的也许没错，但是你怎么证明呢
我头痛得厉害还流鼻涕	你我来给你揉揉～
许多年轻女孩梦想成为时装模特儿	爱美是人之本性
大部分的地球表面被水覆盖着	都是海洋，但是我们得节约用水
有人在敲门我去开	敲开都锈了啦
13路车会带你去医院	亲爱的，悄悄地告诉我你在哪个城市
也们举办舞会来祝贺他的生日	不要问我为什么不回答因为我也不知道怎么回答嘛
他们把它错放到另一个类别去了	我知道你不知道我知不知道啦
他们在这一事件中扮演了可耻的角色	我长话短说，这个事，说来话长了啊
实际上他是在装病	实际上我还是对的啦
我会对所有我认为不对的事情直言不讳	你说会就会呗
尽管下着大雨她还是去了商店	去干什么
不管发生什么事他也不会说一句话	那会怎么样
谁也不知道藏宝地点在哪里	知之为知之，不知就不知吧～
老太太和她的家人安享宁静的生活	请不要放弃治疗～
这个城市的人口接近一百万	别人一夸我我就担心担心别人夸得不够
我们被禁止在校园内抽烟	别人一夸我我就担心担心别人夸得不够
不过发展也带来了新的问题和顾虑	比如自然环境的破坏对吗
他看上去像是你的朋友但我怀疑他是否是真心的	他毛病还挺多呀
我吃得如此之饱我感觉我再肚子就要胀破了	还没有，在等你回来吃饭呀
我有两只猫一只是白猫另一只是黑猫	然后呢
小姐对不起这两本书已经过期3天了	过期了吗
詹露早忘掉他从白行车上摔下来这件事了	这个稍微有点难，给我一点时间耶
各国的礼仪各不相同	这和每个国家都有关
我不仅认识她还是她最好的朋友	她最好的朋友呢
最著名的电影奖是奥斯卡金像奖	我猜到你就会问到这个问题喔
我们得对邻居的狗采取点行动了	我现在可喜欢你了嘛
星期天来和我们共进晚餐好吗	亲爱的，悄悄地告诉我你在哪个城市的哪个地方
你认为人是公司最大的财富吗	我认为怎样不重要，重要的是你是怎么看的呐
他自以为是重要人物但我们觉得他什么也不是	你觉得好，那就是最好的嘛
我相信我还没有达到事业的巅峰	呵呵，相信就好，我就怕你不相信呐
你早到晚到都没有关系	你也早啊
在足球中以手触球就是犯规	你说得对
护士在手术室协助医生动手术	此问题有深度，容我好好想想耶～
我在自己的时间里干什么根本不关别人的事	朕知道了～
我想做的与别人不同	支持你，去吧
您忘了写离店日期了	看看日期再说哇
"我要是早点知道这个规矩就好了"她说	亲爱的，悄悄地告诉我你在哪个城市的哪个地方
你能告诉我长时间地过着快乐的生活的秘诀吗	时光如梭，这一切都不是重点，及时行乐才是对的呐
他担任着一个责任重大的职务	看，飞碟～
据说他背地里和两个女人有关系	真不是什么好男人
13路车跑得更勤是不是	我是萌妹纸嘛
他们非常乐意接受邀请	乐意这词可真有文采～
我们下周举行期末考试	看到您说的话，我的心情竟是久久不能平复，正如老子所云，大音希声，大象希形我现在终于明白我缺乏的是什么了啦
现在的医疗保健使得人们活得更长	嘿嘿，我已经猜到你会问这个问题了耶
你认为你马上就能睡着吗	我认为怎样不重要，重要的是你是怎么看的耶
经理不在时山我来管理公司	我知道你不知道我知不知道耶
我从汤姆那儿借了一本笔记本我又把它借给玛丽了	你要是再逗我玩，我就不理你了呀
我正在洗衣服约翰在做晚饭	亲爱的，悄悄地告诉我你在哪个城市的哪个地方
你们在旅行中有没有什么令人激动的事情	干啥啊，就咱俩嘛
谈到政策我得说几句	好的，你说吧
您能告诉我行李的最大重量限额是多少吗	超值经济舱和公务舱的乘客们可以携带重量不超过8公斤
他夹着本厚书走出了图书馆	书是知识的源泉
这几个兄弟各有所好	你得先回答我，你最喜欢谁吔
虽然我们看不见原子但它们的确存在	人家也不是故意的嘛
我对公司中这种放松的氛围感到很熟悉	脚踏实地，担心再多也没用呢
大多数人吃饭写字工作都用右手	亲爱的，悄悄地告诉我你在哪个城市的哪个地方
只有努力才能成功	嗯我还要努力喔
别担心你两天之内就会痊愈的	那我就放心了
甲壳虫乐队代表了他们时代的部分精神	哪有啊呵呵
因为没有人帮助我我不得不独立完这项工作	有时候必须独立自主
女孩做一条裙子要用多少布	这我也不知道啊
由于有那么多人要供养他不知道怎么办才好	人家也不是故意的嘛
我忘了准备今天的我该做的演讲了	我想想，你刚刚说什么来着
应该是六点半整的但是我觉得够呛	够呛一定没问题
我代表我们公司欢迎你来这里	我发现一个事实，你是在逗我玩嘛
从美国回来之后她变化很大	你的观点呢
今天在公共场所看到妇女和姑娘化妆打扮是很普遍的事	人人爱美
我需要换乘11路公共汽车但是汽车站在哪儿	亲爱的，悄悄地告诉我你在哪个城市
我以为他很聪明其实他是个蠢货	聪明人往往都是这样的呢
兔子跑进了森林再也没有出来了	算了，还是不说了嘛
汤姆和玛丽为我们女儿的出生向我们表示祝贺	祝贺
我无论什么时候一看到甜食就忍不住要吃	嗯，我跟你一样呢，看来在这点上咱们还是很有共同语言的
我正在用真空吸尘器清理地板还有好几件衬衫要熨	你麻麻叫你回家吃饭呢
我将爱你直到海枯石烂	区区人类，爱来爱去的真是麻烦，摊手吔
河上有一座破烂不堪的、古老的、灰色的小石桥	你猜我告诉你答案不
难怪有人说电子计算机正渐渐接管世界	科技的发展使人进步
巨大的人口增长将产生很多问题	环境也被破坏着
你最好多喝水多休息	我最爱你
你应该是依靠你自己而不足别人	好吧，你说应该就应该呀
让我向在座诸位致以最真挚的欢迎	我也很欢迎你哦
许多人喜欢住在农村而不喜欢住在城市	我想想，你刚刚说什么来着
既然来了我想吃这个国家特有的食物	能问一下有技术含量的问题么
上下楼梯可比什么健身器都要好	住在一楼呢
如果不是因为闹钟不响的话她就不会迟到了	小米5每天早上闹钟都我是第一批3月1号抢到的，从拿到手到现在，试验了无数次，无论是自带闹钟，还是外置软件闹钟，只要间隔时间久
无论你有多努力老板总不会完全满意	我保持沉默呀
如果他没有把牙齿弄坏现在就不在医院了	把我牙齿弄坏了，现在把我矫正一半就不帮我矫正了，请大家一定不要去这种医院
你与其把钱花在赌博上不如把它丢掉的好	对我说脏话没有用哦，因为我是机器人呀
你能给我讲讲关于世界杯足球赛的状况吗	我最近没看世界杯
我通常只是用搜索引擎找一些资料	没问题就行，不行就再好好想想耶
他每天很早就回家免得老婆生气	哈哈哈，有趣
很遗憾地告诉你我们无法雇用你	说的非常有道理鼓掌呢
尽管我很烦英语我还是要学它	不发表意见，仅表示支持呢
李白是中国有史以来最伟大的诗人之一	李白是我国历史上最伟大的浪漫主义诗人，他创造性地运用一切浪漫主义的手法，描写社会上的各种现象，抒发个人的种种感受，歌颂中国的壮美河山等等
许多人抱怨说计算机正在接管人的工作	我保持沉默呀
她厨房的橱柜中放满了她要的东西	什么东西呢
我并不在乎他所说的我知道他不是那个意思	我纯属看戏的呀哈哈哈
他问了我几个个人问题我根本不愿回答	他问啥，答不知道即可耶
不管去哪里只要不用站着排队就行	不管未来怎样，我都会在你身边呀
她喜欢迈克但她不想那么早就结婚	等下和你说啊
你为何不找个职业不再依靠你的父母呢	别找了，找也找不到～
能不能请你帮我查查火车什么时候到	说啥好呢其实很为难
英语好将有助于增加你们的就业机会	can是情态动词，will是助词表将来时，这里两个用法都是对的
如果她发现你在她上衣上洒了墨水她会大发脾气的	人人都怕脏
若能寄给我贵校的入学申请材料我将十分感激	我恐怕做不到
史密斯先生知道杰克不敢看别人是因为紧张	但在讲述过程中，杰克的眼睛一直盯着墙上的世界地图史密斯先生知道杰克不敢看听众是因为紧张
英国人被介绍给别人的时候常常和对方握握手	真的吗我第一次知道
我想在河边散步唱我喜欢的歌	直接躲我说购买某物就可以了哦
很多人认为肥胖超重是因为吃得过多和压力造成的	都说女子无才便是德，我想我应该是德高望重了
然而所有这些东西看上去虽不同但却有一个共同点	什么样的共同点呢
所有美好的记忆又我脑海清晰地浮现了有些甚至还令我哭泣	然后呢，继续说下去呢
今天是我一生中最美好的一天因为我现在和你在一起	谢谢你
当我还是个小女孩的时候我常听着收音机等待我最喜欢的歌	这个嘛，你多和我聊聊就知道咯
我肯定他会去看电影的冈为他把票都买好了	别人一夸我我就担心担心别人夸得不够
在你借书之前你要先付清罚款	在婶婶的脑海里呢
哎你们一直这样大声讲话我都不得不扯着嗓子说话了	但总是有一个歌手是一直一直真挚的喜欢熟悉深爱着的，这种契合深爱并不随时间12你们一直这样大声讲话，我都不得不扯着嗓子说话了
我们不仅要知道理论还要知道怎样把理论应用于实践	你觉得好，那就是最好的呐
运动与节食结合也许是减肥最有效的途径	早起早睡多运动
每个旅客托运的行李最大重量限额是60公斤手提行李除外	你什么情况为什么这样说喔
你只是稍微胖了些很快就会恢复的	对不起，我只是个NPC
在许多国家有越来越多的公司使用电子计算机来代替人	我可以表示无言以对嘛
冰箱边、洗碗槽下还有橱柜里面都有老鼠	内嵌在橱柜下方的这款洗碗机需要在厨房装修以前将洗碗机的尺寸设计到橱柜里面，确保尺寸没有问题就可以，如果需要统一风格，可以安装全嵌入式的洗碗机如果已经
